9 0 0 0 0 0 0 0 0 0 9
0 3 3 2 2 2 2 2 3 3 0
5 3 9 0 0 0 0 0 9 3 0
0 2 0 0 1 1 1 0 0 2 0
0 2 0 1 0 4 0 1 0 2 0
0 2 0 0 1 1 1 0 0 2 0
0 3 9 0 0 0 0 0 9 3 0
0 3 3 2 2 2 2 2 3 3 0
9 0 0 0 0 0 0 0 0 0 9