0 0 9 0 0 0 0 0 9 0 0
3 1 3 1 3 1 3 1 3 1 3
0 0 9 0 0 0 0 0 9 0 0
3 1 3 1 3 1 3 1 3 1 3
0 0 9 0 0 0 0 0 9 0 0
3 1 3 1 3 1 3 1 3 1 3
0 0 9 0 0 0 0 0 9 0 0
3 1 3 1 3 1 3 1 3 1 3
0 0 0 0 0 4 0 0 0 0 0